000000000000000000000000000000000000000000000000000000000000000000000000000000000000000000000000000000000000000000000000000000000000000000000000000000000000000000000000000000000000000000000000000000000000000000000000000000000000000000000000
0                                                                                                                                                                                                                                              0
0                                                                                                                                                                                                                                              0
0                                                                                                                                                                                                                                              0
0                                                                                                                                                                                                                                              0
0                     Q                                                         bbbbbbbb   bbbQ              Q           bbb    bQqb                                                        PP                                                 0
0                                                                                                                                                                                          PPP                                                 0
0                                                                                                                                                                                         PPPP                                                 0
0                                                                                                                                                                                        PPPPP                                                 0
0               Q   bQbqb                     LR         LR                  bQb              b     bb    Q  Q  Q     b          bb     P   P          PP   P           bbQb            PPPPPP                                                 0
0                                     LR      lr         lr                                                                            PP   PP        PPP   PP                         PPPPPPP                                                 0
0                           LR        lr      lr         lr                                                                           PPP   PPP      PPPP   PPP    LR              LR PPPPPPPP                                                 0
0                           lr        lr      lr         lr                                                                           PPP   PPP      PPPP   PPP    lr              lrPPPPPPPPP        P                                        0
sssssssssssssssssssssssssssssssssssssssssssssssssssssssssssssssssssss   ssssssssssssss   ssssssssssssssssssssssssssssssssssssssssssssssssssssssssssssssss   ssssssssssssssssssssssssssssssssssssssssssssssssssssssssssssssssssssssssssssssssssss
sssssssssssssssssssssssssssssssssssssssssssssssssssssssssssssssssssss   ssssssssssssss   ssssssssssssssssssssssssssssssssssssssssssssssssssssssssssssssss   ssssssssssssssssssssssssssssssssssssssssssssssssssssssssssssssssssssssssssssssssssss
sssssssssssssssssssssssssssssssssssssssssssssssssssssssssssssssssssss   ssssssssssssss   ssssssssssssssssssssssssssssssssssssssssssssssssssssssssssssssss   ssssssssssssssssssssssssssssssssssssssssssssssssssssssssssssssssssssssssssssssssssss
sssssssssssssssssssssssssssssssssssssssssssssssssssssssssssssssssssssdddssssssssssssssdddssssssssssssssssssssssssssssssssssssssssssssssssssssssssssssssssdddssssssssssssssssssssssssssssssssssssssssssssssssssssssssssssssssssssssssssssssssssss